XXXXXXXXXXXXXXXXXXXXXXXXXXXXXXXXXXXXXXXXXXXXXXXXXXXXXXXXXXXXXXXXXXXXXXXXXXXXXXXXXXX
XX   H                                                                           XX
XX                                               H                               XX
XX                                                                               XX
XX    H             P                                                            XX
XX                                                                               XX
XX                                                                               XX
XX                                                                               XX
XX          H                                                                    XX
XX                                                H                              XX
XX                                                                               XX
XX                                                                               XX
XX                   H                                                           XX
XX                                                                               XX
XX                                                              H  H             XX
XX                                                                               XX
XX                                     H                                         XX
XX                                                                               XX
XX           H                                                                   XX
XX                                                                               XX
XX                                    H            H                             XX
XX                                                                               XX
XX                                                                               XX
XXXXXXXXXXXXXXXXXXXXXXXXXXXXXXXXXXXXXXXXXXXXXXXXXXXXXXXXXXXXXXXXXXXXXXXXXXXXXXXXXXX